R 800 600
NO ./textures/WALL33.xpm
SO ./textures/WALL77.xpm
EA ./textures/WALL17.xpm
WE ./textures/WALL89.xpm
S ./textures/barrel.xpm
C 225,30,50
F 220,100,50

        1111111111111111111111111
        100000000011E002000000021
        1011000001110002001200001
        1001000000000000000000001
111111111011000001112000200200021
100000000011000001110111110111111
11110111111111011100000010001
11110111111111011101010020001
11000000110101011100001010001
10000000000000001100000010001
10000000001000001101010010001
10000011111010111110111100001
11010111 1110101 101111110001
11111111 1111111 111111 11111